[[#####[#####
[[#...###...#
[[#...#O#...#
#####D#.#d#####
#.K.k.........#
#...#.W...#...#
#####..P..#####
#...#....M#...#
#..*..........#
######.#.######
[[[[#..#..#
[[[[#..#..#
[[[[#..#..#
[[[[#######