[[#####[#####
[[#...###...#
[[#...#>#...#
#####D#.#d#####
#.K.k.........#
#...#.W...#...#
#####..P..#####
#...#.....#...#
#..*..........#
######.#.######
[[[[#..#..#
[[[[#..#..#
[[[[#..#..#
[[[[#######