#######
#.......#
#...P...#
#.......#
#.......#
#######