[[#####[#####
[[#...###...#
[[#...#>#...#
#####.#.#.#####
#.............#
#...#.....#...#
#####..P..#####
#...#.....#...#
#.............#
######.#.######
[[[[#..#..#
[[[[#..#..#
[[[[#..#..#
[[[[#######