[[#####[#####
[[#...###...#
[[#...#>#...#
#####.#.#.#####
#..........{..#
#...#.....#...#
#####{.P..#####
#...#.....#...#
#.............#
######.#.######
[[[[#..#..#
[[[[#..#..#
[[[[#..#..#
[[[[#######