[[#####[#####
[[#...###...#
[[#...#>#...#
#####D#.#d#####
#.K.k.........#
#...#.....#...#
#####..P..#####
#...#.....#...#
#..{..........#
######.#.######
[[[[#..#..#
[[[[#..#..#
[[[[#..#..#
[[[[#######