##########
#........#
#..P.....#
#........#
##########